





Foller.me Analytics for Twitter


















































People Search
Looking for someone in the United States? Our free people search engine finds social media profiles, public records, and more!


Search





Twitter Analytics
Twitter analytics shows followers, hashtags, topics, mentions, and other statistics for any public Twitter profile.
Live examples








How Twitter Analytics Works


We gather the requested user's profile and latest tweets. We analyze the tweet's contents and tell you about topics usage in form of "tag clouds" so that you can easily understand which words were the most popular.


We also show you things not shown on public Twitter pages, such as join date, timezone and followers ratio. With Foller.me it's very easy and incredibly fast to make up your mind on whether to follow somebody or not!






Information
The info section shows the publicly available information about a requested Twitter profile. We'll also show you the user's join date and timezone among other things.


Statistics
These are the numbers. Followers, friends, lists and most importantly the followers to following ratio - something you should definitely watch out for before following anybody.




Topics
This section is divided into three sub-sections - topics, hashtags and mentions. Each one is based on the user's latest tweets. Hover your mouse over the items to see their usage.


Inside Tweets
We take you through the user's latest tweets and their contents in an easy to understand and short table. Tweets, retweets, tags, replies, mentions, links, media and more. A great way to spot spammers and automated accounts.




Attitude
New! We scan for smiley faces through the latest user's tweets and count the happy ones versus the sad ones. Not at all times valuable, but can easily spot emotions.


Time
New! This section will show you what time the user's most active at. Not only valuable info about the best time to reach the user but can also spot spammers and automated accounts.








How to Find a Person Using Foller

A
B
C
D
E
F
G
H
I
J
K
L
M
N
O
P
Q
R
S
T
U
V
W
X
Y
Z

Having trouble using our people search form because you don't remember someoneâ€™s first or last name? We have a solution. You can find any person in just two clicks by simply browsing our directory of people living in the US.



Aaron Abbott - Anne Allen
Anne Andrews - Bradley Armstrong
Bradley Ashford - Celeste Ashford
Celeste Avery - Crystal Arocha
Crystal Ashley - Dennis Altom
Dennis Alvarado - Ellen Ahrens
Ellen Alderson - Ginger Allinson
Ginger Armstrong - James Alsup
James Altenhofen - Jessie Adcock
Jessie Alexander - Joy Ashcraft
Joy Ashley - Kevin Abbott
Kevin Abraham - Leta Anthony
Letha Allen - Marilyn Alexander
Marilyn Alford - Michael Andis
Michael Andrade - Patric Anderson
Patrice Adams - Rhonda Atwood
Rhonda Avery - Sadie Applewhite
Sage Arnold - Stacey Archer
Stacey Arledge - Thomas Aikman
Thomas Akers - Warner Allen
Warren Adams - Zoi Astifan
Aaron Bagwell - Alison Boland
Alison Bosshardt - Amy Bowen
Amy Bower - Ann Bramucci
Ann Brandt - Ashley Brewer
Ashley Brickey - Benjamin Ball
Benjamin Ballard - Bill Beeson
Bill Beever - Brad Buttrum
Brad Byers - Brian Bell
Brian Bellott - Candace Boere
Candace Boger - Carolyn Bloom
Carolyn Blount - Charlene Benson
Charlene Bettis - Chris Beeler
Chris Bell - Clarissa Byrd
Clark Bailey - Craig Bean
Craig Beckwith - Daniel Blanchard
Daniel Blanton - David Bengtson
David Benham - Deborah Bierman
Deborah Biggers - Derick Buirts
Derik Bain - Donald Buchanan
Donald Buck - Doyle Burt
Doyle Byrd - Elizabeth Bauder
Elizabeth Baxter - Erma Blackburn
Erma Blevins - Frank Bailey
Frank Baker - Gayle Bowman
Gayle Bradley - Glenn Bolton
Glenn Boothe - Harvie Banks
Harvie Beaver - Hunter Ballard
Hunter Bay - James Beebe
James Beegle - Janet Bachmann
Janet Backes - Jean Bell
Jean Bender - Jennifer Burgin
Jennifer Burke - Jessica Burnett
Jessica Burns - Joe Beavers
Joe Beck - Johnnie Blair
Johnnie Bolin - Joshua Bonham
Joshua Boone - Julie Beard
Julie Beasley - Karyn Beckner
Karyn Blair - Keith Bonds
Keith Bones - Keshia Black
Keshia Briscoe - Kristie Buck
Kristie Bullock - Lashawna Branch
Lashawnda Butler - Lemuel Boyd
Lemuel Burns - Linda Bramlett
Linda Brammer - Lori Barrett
Lori Barrington - Mandy Berry
Mandy Bewley - Mark Beatty
Mark Beauregard - Mary Beals
Mary Beam - Megan Britt
Megan Brooks - Michael Biskey
Michael Bissell - Misty Birdwell
Misty Bishop - Nathaniel Brown
Nathaniel Burke - Pam Barker
Pam Beckham - Patty Bates
Patty Beaver - Philip Bynum
Phillip Bailey - Randy Burris
Randy Burrough - Rhonda Bobo
Rhonda Bodoin - Robert Batson
Robert Batte - Roger Beshears
Roger Best - Roy Browning
Roy Bruce - Samuel Bushey
Samuel Butler - Sean Bars
Sean Beard - Shayla Baker
Shayla Barnes - Shirley Brotherton
Shirley Brown - Stephen Boeckman
Stephen Bogan - Suzanne Bain
Suzanne Baker - Tereasa Barton
Terence Bass - Thomas Bellus
Thomas Bemberg - Tom Brewer
Tom Bridges - Troy Barrios
Troy Barron - Vincent Biondi
Vincent Bishop - Will Bass
Will Battles - Zacary Bryson
Zach Baker - Zyla Brown
Aaren Cassidy - Alta Carroll
Alta Clark - Angela Chance
Angela Chancellor - Ariana Caballero
Arica Clay - Belinda Clark
Belinda Classen - Billy Corley
Billy Cornish - Brenda Chism
Brenda Chisom - Calvin Campbell
Calvin Canady - Carolyn Cowart
Carolyn Cowens - Charles Chappell
Charles Chartier - Christine Coleman
Christine Collins - Colette Comeau
Colette Crook - Dale Corbit
Dale Cowart - David Carpenter
David Carr - Debra Cater
Debra Cates - Dianna Caldwell
Dianna Cannon - Dorothy Clark
Dorothy Clay - Elizabeth Calaway
Elizabeth Caldwell - Ettie Craven
Eugene Camp - Gail Crosby
Gail Crutchfield - Glen Cromer
Glen Crowley - Heather Canterbury
Heather Cantrell - Jack Counihan
Jack Cowell - Jamie Caradine
Jamie Carelock - Jason Couch
Jason Courington - Jennifer Cusick
Jennifer Cutler - Jimmy Canady
Jimmy Cannon - John Coffey
John Coffin - Josh Cossey
Josh Cox - Julius Crabtree
June Cali - Kathryn Clarkson
Kathryn Claussen - Kenneth Colley
Kenneth Collier - Kristi Cody
Kristi Collins - Laura Cheak
Laura Cheri - Letitia Calvert
Letitia Cross - Lois Coleman
Lois Coley - Malcolm Curne
Malcom Campbell - Mark Corley
Mark Corliss - Mary Creed
Mary Creek - Meredith Catlett
Meredith Causey - Milton Crabtree
Milton Craig - Nekita Cooley
Nelda Caldwell - Pat Clark
Pat Clinton - Paulette Coger
Paulette Cole - Randall Cobb
Randall Cochran - Rhonda Craig
Rhonda Cravens - Robert Conway
Robert Cook - Rosa Carper
Rosa Carrillos - Samuel Collier
Samuel Collins - Shane Copes
Shane Coursey - Sheree Coston
Sheree Cox - Stella Collier
Stella Collins - Susan Crace
Susan Craddock - Teresa Coleman
Teresa Coley - Timothy Caffrey
Timothy Cagle - Tracy Cobb
Tracy Cochran - Victoria Crumpton
Victoria Cummins - William Casey
William Cash - Zula Cline
Aarika Daniel - Andrea Dancy
Andrea Darby - Barbara Daniel
Barbara Daniels - Bobbye Dennis
Bobbye Dye - Carl Dolan
Carl Donaldson - Charlie Davis
Charlie Dean - Cordell Davenport
Cordell Davis - David Daniel
David Daniell - Dennis Doner
Dennis Donovan - Douglas Duncan
Douglas Dunn - Eugene Duderstadt
Eugene Duke - Gina Driscoll
Gina Drobena - Hugh Dunlap
Hugo Devora - Janet Dyal
Janet Dye - Jerry Dickens
Jerry Dickerson - John Driskill
John Driver - Junior Duncan
Justen Davis - Kenneth Dees
Kenneth Deese - Lasonya Davis
Latanya Doyle - Lindsey Dinwiddie
Lindsey Dixon - Mari Davis
Mari Dobbs - Matthew Dozier
Matthew Drake - Miranda Desoto
Miranda Dixon - Pamela Downing
Pamela Downs - Rachel Doherty
Rachel Dolden - Rita Dabbs
Rita Daniel - Roxanna Dunlap
Roxanne Daily - Shannon Dixon
Shannon Doane - Stephanie Deloach
Stephanie Dement - Taylor Desens
Taylor Devine - Tommy Driggers
Tommy Due - Wanda Diggs
Wanda Dilbeck - Zona Dahl
Aaron Easley - Barry Eggers
Barry Elliott - Carol Eudy
Carol Evans - Cynthia Eaves
Cynthia Eby - Donna Ebert
Donna Echols - Gary East
Gary Easterling - Jamey Emerson
Jami Eaves - John Eberle
John Ebner - Kelley England
Kelley Erstine - Linda Ecker
Linda Eddings - Marylyn Ellis
Matt Echols - Olen Ervin
Olga Elwood - Rick East
Rick Edgar - Shannon Edwards
Shannon Elder - Terri Efird
Terri Ehrlich - Wendell Earnest
Wendell Edwards - Zona Ellis
Aaron Fairclough - Anita Fleming
Anita Floyd - Betty Flemons
Betty Fletcher - Bryan Flammang
Bryan Fletcher - Charley Fortner
Charley Foulk - Curtis Forrest
Curtis Foster - Deborah Farmer
Deborah Farrar - Dorothy Fallin
Dorothy Farmer - Evelyn Fachin
Evelyn Farmer - Gordon Fleming
Gordon Floyd - James Fitzgibbon
James Fitzhugh - Jennifer Fluech
Jennifer Fogleman - John Forte
John Fortenberry - Kandis Fisher
Kandy Farmer - Kevin Fitch
Kevin Fitterling - Lenore Fobert
Leo Faulkner - Madge Franks
Madonna Foster - Matthew Frisby
Matthew Fritsche - Nadine Fuller
Nakeisha Ford - Paul Frantz
Paul Franzen - Richard Falkner
Richard Faller - Roxie Fleming
Roy Farley - Shaun Furr
Shauna Foster - Sue Fonzie
Sue Forbis - Timothy Feltman
Timothy Fennessee - Walter Frey
Walter Frost - Zyanya Flores



Personal Information on Social Media
Social media is an excellent source for finding personal information about someone. On a social media profile, you can find the person's name, gender, education, employment, interests, hobbies, images, relationship status, and family details. Our free people search engine includes links to more than 15 million social profiles on Twitter, Instagram, TikTok, IMDb, LinkedIn, and Medium.



Aaron Gaffigan - Ana Gallardo
Ana Garcia - Ashley Goodman
Ashley Goodspeed - Billie Gibson
Billie Gilchrist - Brian Greuel
Brian Grier - Carroll Gadberry
Carroll Garner - Christina Greeson
Christina Gregory - Curtis Gamble
Curtis Gardner - David Gray
David Greathouse - Diana Gregory
Diana Griffin - Earnest Gardner
Earnest Gary - Ethan Gammill
Ethan Glover - George Gammon
George Gann - Hayden Goss
Hayley Gilbert - James Gallaher
James Gallaway - Jason Grant
Jason Grantham - Jessica Gordon
Jessica Gore - Johnathan Goodwin
Johnathan Goree - Juliann Green
Julianne Garrity - Kelley Graham
Kelley Grandy - Kyle Gittins
Kyle Gleghorn - Lesley Galbraith
Lesley Gardner - Lorri Green
Lorrie Glover - Mark Granberry
Mark Granger - Melba Garrett
Melba Garrison - Misty Gentry
Misty George - Pamela Gaskin
Pamela Gass - Phillip Gipson
Phillip Givens - Rhonda Glenn
Rhonda Glover - Rodney Granberry
Rodney Graves - Samuel Gilbert
Samuel Giles - Shayla Gibson
Shayne Gaither - Stephen Gideon
Stephen Giese - Ted Gann
Ted Gardner - Tina Guerrero
Tina Guevara - Vickie Graham
Vickie Grattan - Windy Gay
Winfred Gates - Zoe Guthrie
Aaron Hagan - Allen Holton
Allen Hope - Andrew Hahn
Andrew Hale - Anthony Hess
Anthony Hester - Barbara Hodges
Barbara Hodnett - Betty Holyfield
Betty Honea - Bonnie Hamilton
Bonnie Hamm - Brian Hartman
Brian Hartwig - Carey Hignight
Carey Hill - Carroll Harrison
Carroll Hart - Charles Higgins
Charles Higgs - Christine Hendricks
Christine Hendrickson - Cobi Hendrix
Coby Hall - Cynthia Huskey
Cynthia Hutchins - Darrell Hayden
Darrell Hayes - Deborah Hammonds
Deborah Hampton - Derrick Hale
Derrick Hamilton - Donna Heinze
Donna Helmer - Dylan House
Dylan Hurd - Elliot Hartle
Elliot Hunt - Evelyn Howell
Evelyn Hubbard - Garrett Hensley
Garrett Houck - Gina Hudson
Gina Hughes - Handy Hamilton
Hani Hashem - Hollis Hatch
Hollis Hughes - Jaime Holt
Jaime Howell - Jane Holmes
Jane Holmun - Jean Hester
Jean Hicks - Jenny Holleman
Jenny Hollis - Jillian Harrell
Jillian Harris - John Haguewood
John Hahn - Jonathan Huckabee
Jonathan Huddleston - Judy Hallmark
Judy Halsted - Karen Hotchkiss
Karen Houk - Keeton Hearn
Keiana Hunter - Kevin Harp
Kevin Harper - Krystal Howell
Krystal Hughes - Laura Howell
Laura Hoyt - Leslie Humbert
Leslie Humiston - Lisa Holsapple
Lisa Holt - Lydia Hardin
Lydia Harrigan - Marie Hunter
Marie Hyde - Martin Henry
Martin Herman - Maurice Houston
Maurice Huey - Michael Havens
Michael Hawkins - Misty Hervey
Misty Hester - Nell Harris
Nell Hattabaugh - Pamela Hinders
Pamela Hindes - Paula Haile
Paula Halbrook - Rachel Hamm
Rachel Hamner - Rebekah Harrington
Rebekah Harris - Ricky Henderson
Ricky Hendricks - Rodney Hallmark
Rodney Hallsell - Roy Hart
Roy Hartman - Sandra Hartline
Sandra Hartman - Shanitra Hussian
Shanley Horton - Shemeka Hunter
Shemekia Hicks - Stanley Harris
Stanley Harrison - Susan Hampton
Susan Hanan - Tanzania Holt
Tara Hacker - Theresa Hufford
Theresa Huggins - Tom Hanlon
Tom Hansen - Tyler Hopper
Tyler Houpt - Virginia House
Virginia Howard - William Heim
William Heimbach - Zondra Harris
Aaron Ingle - Gale Ison
Gary Imler - Matthew Isabell
Matthew Isbell - Whitney Imhoff
Whitney Irvin - Zoran Ilic
Aaron Yacavone - Donna Yardley
Donna Yates - Keith Yancey
Keith Yeager - Rebecca York
Rebecca Young - Zeola Yeager
Aaron Jackson - Barbara Johns
Barbara Johnson - Carol Jameson
Carol Jarrett - Cynthia Jauch
Cynthia Jeffers - Donna Jetton
Donna Jewell - Frank Jensen
Frank Jevicky - Ivone Johnson
Ivory Jackson - Jessie Johnson
Jessie Johnston - Kathleen Jackson
Kathleen Jamison - Laveta Johnson
Lavita Johnson - Margie James
Margie Jameson - Mona Jackson
Mona Janes - Ramona Jones
Ramona Jorgensen - Sammy Justus
Sammye Johnston - Stewart Johnston
Stewart Jones - Twanna Johnson
Twila Johnson - Zula Johnson
Aaron Kamps - Arthur King
Arthur Kirby - Brenda Kimbrell
Brenda Kimery - Charles Kincaid
Charles Kindle - Damon Keith
Damon Kenison - Destiny Kersten
Destiny Knighten - Eric Kremers
Eric Kriner - Harmony Kalb
Harold Keathley - Janet King
Janet Kinsey - Joan Kennedy
Joan Key - Julie Kelly
Julie Kelso - Kevin Kemp
Kevin Kendrick - Leonard Krueger
Lera Kinder - Mark Keith
Mark Kellar - Michael Kirby
Michael Kiriakidis - Patricia Kreider
Patricia Kremers - Richard Killough
Richard Kimball - Samantha King
Samantha Kirk - Stella Koch
Stella Kreh - Thomas Kremers
Thomas Kristoffersen - Whitney Keeton
Whitney Kelly - Zora Kendall
Aaron Laird - Andrew Lueders
Andrew Luker - Barbara Lovin
Barbara Lowden - Bradley Lyon
Brady Lacy - Carmon Lewis
Carol Lacey - Cheryl Lusk
Cheryl Luther - Courtney Loy
Courtney Lucas - David Lillquist
David Lilly - Diedre Lee
Dillon Lawrence - Elisa Lancaster
Elisabeth Ladd - Freda Locke
Freda Lough - Gwendolyn Lancaster
Gwendolyn Lane - Jacquelyn Lindsay
Jacquelyn Littlefield - Jay Laster
Jay Lawrence - Jillian Langley
Jillian Lopez - Jordan Looney
Jordan Lowery - Karen Lockhart
Karen Lody - Kevin Langston
Kevin Lanos - Laura Liles
Laura Linares - Lisa Leamons
Lisa Lee - Marie Lachowsky
Marie Lackey - Matthew Loveless
Matthew Lovell - Mildred Linn
Mildred Lott - Pamela Landon
Pamela Landry - Polly Lang
Polly Lawson - Ricky Lacy
Ricky Laden - Roy Lee
Roy Leland - Shane Long
Shane Looney - Stacy Luper
Stacy Luster - Tanya Lauderdale
Tanya Lee - Todd Lickliter
Todd Liles - Virginia Little
Virginia Littlefield - Zoraida Lopez



Social Media User Statistics
Are you looking for social media users statistics? Find the latest Facebook, Instagram, Twitter, and TikTok users numbers year by year, by country, by demographics, and more.

Facebook Users Statisitcs
Instagram Users Statisitcs
Twitter Users Statisitcs
TikTok Users Statisitcs




Personal Information on Public Records
Our USA people database also includes the person's name, birth date, phone number, email, and address information that we found in US public records and official documents. Here are the most common types of public records shared by government agencies and made available to the public:

birth, death, marriage, and divorce certificates;
voter registration and military records;
business and professional licenses;
property records, including deeds, mortgages, and liens;
criminal and court records, including lawsuits, judgments, and legal filings.

It's important to note that the availability and accessibility of public records vary by jurisdiction, and some types of information may be more difficult to obtain than others. Additionally, some public records are subject to fees or restrictions on access.



Aaliya Mahmood - Allen Mcdonald
Allen Mcdowell - Andrea Meyer
Andrea Miers - Annie Madden
Annie Malone - Barbara Matheny
Barbara Mather - Betty Manning
Betty Mannis - Bobby Mcdowell
Bobby Mcelroy - Brent Miller
Brent Mills - Candi Mercer
Candi Moody - Carolyn Myrie
Carolynn Masson - Charles Mcclendon
Charles Mcclintock - Christina Massingill
Christina Matheny - Clinton Morton
Clinton Moses - Cynthia Mcminn
Cynthia Mcnair - Darleen Magen
Darlena Mercer - Deana Mccorkle
Deana Mccormack - Denise Meli
Denise Menhinick - Donald Mccauley
Donald Mcclellan - Douglas Murphy
Douglas Murray - Elizabeth Mayo
Elizabeth Mays - Ernest Malloy
Ernest Martin - Franklin May
Franklin Mayhue - George Meadows
George Meek - Gregory Marlow
Gregory Marrufo - Henrietta Marshall
Henrietta Miller - Jacky Miner
Jacky Moore - Jamey Mcgaugh
Jamey Milam - Jason Mattingly
Jason Matyja - Jennifer Marshall
Jennifer Martin - Jessica Mays
Jessica Mcafee - Joe Mccauley
Joe Mcclain - Johnny Maynard
Johnny Mayo - Joy Morris
Joy Moseley - Justin Maland
Justin Mallett - Kathryn Mathis
Kathryn Maus - Kendra Meredith
Kendra Metcalf - Kimberly Modica
Kimberly Moffat - Larry Majors
Larry Mallard - Leann Myers
Leanna Mcclendon - Linda Mcelwee
Linda Mcfall - Lori Majors
Lori Malone - Mandy Meaux
Mandy Medley - Mark Malone
Mark Malugen - Mary Matthiessen
Mary Maulden - Megan Martin
Megan Mason - Michael Maxwell
Michael May - Mildred Morgan
Mildred Morris - Naomi Martine
Naomi Massey - Ora Mcknight
Ora Moore - Patsy Mcbee
Patsy Mcbride - Philip Miller
Philip Miron - Ray Mayers
Ray Mcadams - Richard Maness
Richard Mangrum - Robert Mcdougald
Robert Mcdowell - Ronald Mccraw
Ronald Mccullough - Ruth Mccullough
Ruth Mcdade - Sara Mills
Sara Milner - Sharon Mahar
Sharon Maher - Sherrie Mcadams
Sherrie Mcadow - Stella Murry
Stella Myers - Susan Mcnabb
Susan Mcneel - Telisha Moore
Telly Mitchell - Thomas Mcgehee
Thomas Mcghee - Tommy Moran
Tommy Morehead - Van Morris
Van Murphy - Walter Malone
Walter Manger - William Means
William Mears - Zora Mayo
Aaron Nachmann - Betty Nannie
Betty Napier - Charles Norwood
Charles Nowak - Deborah Newby
Deborah Newell - Evelyn Newsom
Evelyn Newton - James Napolitano
James Narup - John Nebling
John Neel - Kerry Nosler
Kesha Nye - Loyd Neal
Loyd Nugent - Michelle Nye
Mickey Nesbitt - Randall Nicholas
Randall Nichols - Sarah Neumeier
Sarah Newhart - Teresa Newell
Teresa Newman - William Norvell
William Norwood - Zula Nowlin
Aaron O'brien - Carolyn Oetjen
Carolyn Ogden - Donald Ott
Donald Otto - Jan Oneal
Jan Organ - Kayle Osburn
Kecia Osborne - Mary Orsini
Mary Ortiz - Rhonda Oswald
Rhonda Oswalt - Sylvia Olson
Sylvia Oneill - Zula Owens
Aaron Pace - Amy Pockrus
Amy Poindexter - Ashley Peden
Ashley Peele - Billie Potter
Billie Powell - Bridgett Paul
Bridgett Phillips - Catherine Paul
Catherine Payne - Christopher Penny
Christopher Penrod - Cynthia Pruett
Cynthia Pruitt - Dayne Phillips
Dean Pace - Don Pounds
Don Prescott - Edward Parsons
Edward Partridge - Faye Pyatt
Felecia Patterson - Gina Pentz
Gina Perdue - Herbert Perry
Herbert Phelps - James Pritchett
James Privett - Jeffrey Pataky
Jeffrey Patrick - Jimmy Peden
Jimmy Peeples - Jonathan Payne
Jonathan Pearcy - Justin Pinkerton
Justin Pinkley - Ken Penix
Ken Perdue - Lana Parish
Lana Parker - Levi Prater
Levi Prowell - Lura Powell
Luther Parris - Martha Pervin
Martha Pettigrew - Melonie Parker
Melonie Parks - Nancy Peacock
Nancy Pearce - Patricia Povis
Patricia Powell - Racheal Price
Rachel Palmer - Richard Poston
Richard Poteet - Ronald Pointer
Ronald Poley - Sandy Polk
Sandy Porter - Shelly Perry
Shelly Pershall - Steven Palmer
Steven Pangle - Teri Porter
Teri Powell - Tonya Petet
Tonya Petross - Walter Powell
Walter Price - Zoran Peters
Aaron Qualls - Sherry Quick
Sheryl Qualls - Zachary Qualls
Aaron Raglon - Amy Reyna
Amy Reynolds - Armando Rivera
Armando Rodriguez - Betty Ridgeway
Betty Ridling - Brenda Rivas
Brenda Roach - Carol Raber
Carol Rachal - Charles Robertson
Charles Robinett - Claude Riggin
Claude Riley - Daniel Reber
Daniel Reddell - Deborah Reed
Deborah Reeder - Donald Richardson
Donald Richey - Edward Ruple
Edward Rush - Felecia Rhodes
Felecia Rinehart - Gerry Rhyne
Gerry Robinson - Henry Raynor
Henry Reaves - James Robins
James Robinson - Jeff Rea
Jeff Redmon - Jim Richardson
Jim Rider - Jon Robison
Jon Rodgers - Justin Raver
Justin Ray - Kelly Rawlins
Kelly Ray - Krystal Robinson
Krystal Ross - Leon Rinke
Leon Riordan - Lori Ripperger
Lori Riser - Mark Rahn
Mark Raiford - Megan Randolph
Megan Rapp - Milton Robinson
Mimi Ryan - Norris Russell
Nyesha Rogers - Peggy Reece
Peggy Reed - Rebecca Raynor
Rebecca Read - Robert Reis
Robert Reitman - Roy Roland
Roy Rolins - Selina Rowell
Selina Russell - Shirley Ridge
Shirley Rieder - Susan Richmond
Susan Ridenour - Terry Rounds
Terry Rowland - Tracey Rogers
Tracey Rosenau - Vivian Roy
Vivian Rudolph - Zina Rhodes
Aaron Sadler - Allen Sullivan
Allen Sutterfield - Andrea Swanson
Andrea Swift - Annie Smith
Annie Snow - Barbara Sipes
Barbara Sirois - Betty Stearns
Betty Stechly - Bonnie Stewart
Bonnie Stocks - Brian Southard
Brian Southerland - Carl Salsman
Carl Sams - Carrie Stout
Carrie Strack - Charles Standridge
Charles Stanford - Christopher Saulsbury
Christopher Saunders - Connie Sides
Connie Simmons - Dale Stringfellow
Dale Strong - Darrin Stephens
Darrin Storms - Debbie Staggs
Debbie Staley - Dennis Swinford
Dennise Smith - Donato Sutton
Donavon Somers - Dustin Steen
Dustin Stevens - Elizabeth Stinnett
Elizabeth Stith - Eugene Sutton
Eugene Swain - Gail Sowell
Gail Speer - Ginger Speer
Ginger Spiller - Harley Strang
Harlon Sims - Holly Strickland
Holly Struble - James Schill
James Schisler - Janel Stryker
Janel Swift - Jeanell Stuckey
Jeanene Smith - Jeremy Saul
Jeremy Saulsbury - Jimmie Stephens
Jimmie Stevens - John Sherrill
John Sherrod - Jordan Sowers
Jordan Staley - Judy Shepherd
Judy Sherman - Karen Stotts
Karen Stout - Keith Schalk
Keith Scheffler - Kevin Satterfield
Kevin Saul - Kristopher Sanders
Kristopher Sikes - Laura Shepherd
Laura Shere - Leslie Shaw
Leslie Sheely - Lisa Shaddix
Lisa Shands - Lurlene Sanders
Lurlene Spears - Marianne Sanders
Marianne Satterfield - Martha Silva
Martha Simmons - Matthew Selman
Matthew Severs - Merle Stovall
Merlene Scott - Michelle Summerville
Michelle Sumner - Naoma Smith
Naomi Sanders - Omer Singleton
Omer Smith - Patsy Slezak
Patsy Sloan - Philip Stinnett
Philip Stockwell - Ray Spears
Ray Spence - Richard Scaggs
Richard Scallion - Robert Shirey
Robert Shirley - Ronald Schriner
Ronald Schrodt - Ruth Sanchez
Ruth Sanders - Sara Sikes
Sara Silverman - Shannon Stinson
Shannon Stocker - Sherri Steelman
Sherri Stephens - Stephanie Schriner
Stephanie Schroeder - Susan Santos
Susan Sasseen - Tara Seale
Tara Sexton - Thomas Sandlin
Thomas Sandusky - Tom Sutherland
Tom Sutton - Vada Smith
Vada Stone - Wallace Sewell
Wallace Shaver - William Southern
William Sowell - Zulema Soto
Aaron Tarter - Angela Toney
Angela Toomer - Betty Telles
Betty Temple - Brooke Taylor
Brooke Thayer - Charles Tims
Charles Tinkle - Craig Taylor
Craig Teague - Deborah Tarver
Deborah Tate - Douglas Tate
Douglas Taylor - Fay Todd
Fay Tomlinson - Gregory Trigg
Gregory Trosper - James Tims
James Tinch - Jenny Tuberville
Jenny Tucker - John Tyner
John Tyra - Karen Tompsett
Karen Torrence - Kimberly Trump
Kimberly Trusty - Leslie Taylor
Leslie Teaff - Mandy Thompson
Mandy Thornton - Matthew Toon
Matthew Tosh - Mollie Tipton
Molly Taylor - Patrick Turner
Patrisha Thompson - Reina Tolentino
Remmel Taylor - Ronnie Tanner
Ronnie Tarrants - Shannon Tartt
Shannon Tate - Stephen Tricarico
Stephen Trim - Terry Tuell
Terry Turner - Tyler Thompson
Tyler Thornton - Windy Tyson
Winford Taylor - Zoran Todorovic
Aaron Uthoff - Matthew Ulmer
Matthew Underwood - Yvonne Uzzell
Aaron Valley - Carolyn Voss
Carrie Vance - Dwight Vanwinkle
Dwight Vincent - Jeffrey Venable
Jeffrey Vent - Kimmy Varner
Kin Vong - Michael Vaughan
Michael Vaughn - Ronda Vaughan
Ronda Vines - Todd Verrone
Todd Vickery - Zeynep Vural
Aaric Williams - Amanda West
Amanda Westbrook - Anna Weaver
Anna Webb - Barbara Willett
Barbara Williams - Billy Webb
Billy Weeks - Bret Wilson
Bret Winingar - Carleen White
Carlena Weakley - Chance Williams
Chance Woods - Christine Watson
Christine Weathers - Cora Womack
Cora Wright - Danny Wade
Danny Wadley - Debbie Wood
Debbie Woodward - Diane Wamhoff
Diane Ward - Douglas Weaver
Douglas Webb - Ellen Ward
Ellen Warner - Felecia Williams
Felica Washington - Genia Walker
Genia White - Gwendolyn Whitfield
Gwendolyn Whitlock - Irene White
Irene Whittaker - Jan Wilson
Jan Wolf - Jeffrey Wardlaw
Jeffrey Warren - Jewell Walter
Jewell Watkins - John Wisener
John Wisinger - Judd Williams
Judge Williams - Kate Wilcox
Kate Wyers - Kenneth Weatherly
Kenneth Weathers - Kristy Whitmire
Kristy Whittingham - Laverne Williams
Laverne Wilson - Linda Williamson
Linda Willis - Lucille Williams
Lucille Wilson - Marilyn Wilkinson
Marilyn Willey - Mary Winters
Mary Wirth - Michael Weeks
Michael Wegerer - Myra Welch
Myra White - Ollie Weaver
Ollie Wesley - Paula Wiggins
Paula Wiley - Randy Waters
Randy Watkins - Rick Wilcox
Rick Wilkins - Ronald Wagner
Ronald Wahl - Sally Wiser
Sally Witt - Shannon Watson
Shannon Watts - Sheryl Welch
Sheryl Wells - Steven Wheatley
Steven Wheeler - Tavares Watkins
Tavia Wallace - Tim Woodbury
Tim Woody - Trina Welch
Trina Wester - Vivian Willis
Vivian Wilson - Winfred Ward
Winfred Watt - Zona Wilson
Adam Xaysuda - Youa Xiong
Adam Zeiger - Margaret Ziccardi
Margaret Zimmerman - Zachary Ziegler


























Contact Us
Do Not Sell My Info
Privacy Policy
Terms and Conditions



We are not a consumer reporting agency as defined by the Fair Credit Reporting Act (FCRA). Foller.me can't be used to make decisions about employment, tenant screening, or any related purpose covered by the FCRA. We are not affiliated, associated, authorized, endorsed by, or in any way officially connected with the Federal Trade Commission and the Federal Communications Commission.Created using the Twitter API & Bootstrap. Not affiliated with Twitter, Inc.



                    Â© 2009 - 2022 Foller.me
                






